powiat bolesławiecki - powiat zgorzelecki; powiat lubański; powiat lwówecki; powiat złotoryjski; powiat legnicki; powiat polkowicki; powiat żagański; DONE
powiat dzierżoniowski - powiat wrocławski; powiat świdnicki; powiat wałbrzyski; powiat ząbkowicki; powiat strzeliński; powiat kłodzki; DONE 
powiat głogowski - powiat polkowicki; powiat lubiński; powiat górowski; powiat nowosolski; powiat wschowski; DONE
powiat górowski - powiat leszczyński; powiat rawicki; powiat trzebnicki; powiat wołowski; powiat lubiński; powiat głogowski; powiat wschowski; DONE
powiat jaworski - powiat legnicki; powiat średzki; powiat świdnicki; powiat wałbrzyski; powiat kamiennogórski; Jelenia Góra; powiat złotoryjski; DONE
powiat jeleniogórski - powiat jaworski; Jelenia Góra; powiat kamiennogórski; powiat lwówecki; powiat złotoryjski; DONE
powiat kamiennogórski - powiat jeleniogórski; powiat jaworski; powiat wałbrzyski; DONE
powiat kłodzki - powiat wałbrzyski; powiat dzierżoniowski; powiat ząbkowicki; DONE 
powiat legnicki - powiat złotoryjski; powiat lubiński; powiat wołowski; powiat polkowicki; powiat średzki; powiat jaworski; powiat bolesławiecki; DONE
powiat lubański - powiat zgorzelecki; powiat bolesławiecki; powiat lwówecki; DONE
powiat lubiński - powiat wołowski; powiat górowski; powiat głogowski; powiat polkowicki; powiat legnicki; DONE
powiat lwówecki - powiat bolesławiecki; powiat jeleniogórski; powiat lubański; powiat złotoryjski; DONE
powiat milicki - powiat oleśnicki; powiat trzebnicki; powiat rawicki; powiat krotoszyński; powiat ostrowski; DONE
powiat oleśnicki - powiat oławski; powiat wrocławski; powiat trzebnicki; powiat milicki; powiat ostrowski; powiat ostrzeszowski; powiat kępiński; powiat namysłowski; DONE
powiat oławski - powiat strzeliński; powiat wrocławski; powiat oleśnicki; powiat namysłowski; powiat brzeski; DONE
powiat polkowicki - powiat żagański; powiat głogowski; powiat bolesławiecki; powiat legnicki; powiat lubiński; DONE
powiat strzeliński - powiat oławski; powiat wrocławski; powiat dzierżoniowski; powiat ząbkowicki; powiat nyski; powiat brzeski; DONE
powiat średzki - powiat trzebnicki; powiat wołowski; powiat legnicki; powiat jaworski; powiat świdnicki; DONE
powiat świdnicki - powiat jaworski; powiat średzki; powiat wrocławski; powiat dzierżoniowski; powiat wałbrzyski; DONE
powiat trzebnicki - powiat milicki; powiat oleśnicki; powiat średzki; powiat górowski; powiat wołowski; powiat wrocławski; powiat rawicki; Wrocław; DONE
powiat wałbrzyski - powiat kamiennogórski; powiat jaworski; powiat świdnicki; powiat dzierżoniowski; powiat kłodzki; DONE
powiat wołowski - powiat średzki; powiat legnicki; powiat lubiński; powiat górowski; powiat trzebnicki; DONE
powiat wrocławski - Wrocław; powiat dzierżoniowski; powiat świdnicki; powiat średzki; powiat trzebnicki; powiat oleśnicki; powiat oławski; powiat strzeliński; DONE 
powiat ząbkowicki - powiat kłodzki; powiat dzierżoniowski; powiat strzeliński; powiat nyski; DONE
powiat zgorzelecki - powiat bolesławiecki; powiat lubański; powiat żarski; powiat żagański; DONE
powiat złotoryjski - powiat legnicki; powiat jaworski; powiat jeleniogórski; powiat lwówecki; powiat bolesławiecki; DONE
Jelenia Góra - powiat jeleniogórski; DONE
Legnica - powiat legnicki; DONE
Wałbrzych - powiat wałbrzyski; DONE
Wrocław - powiat wrocławski; DONE
powiat aleksandrowski - powiat toruński; powiat lipnowski; powiat wrocławski; powiat radziejowski; powiat inowrocławski; DONE 
powiat brodnicki - powiat grudziądzki; powiat wąbrzeski; powiat golubsko-dobrzyński; powiat rypiński; powiat żuromiński; powiat działdowski; powiat nowomiejski; DONE
powiat bydgoski - powiat nakielski; powiat sępoleński; powiat tucholski; powiat świecki; powiat chełmiński; powiat toruński; powiat inowrocławski; powiat żniński; DONE
powiat chełmiński - powiat świecki; powiat bydgoski; powiat toruński; powiat wąbrzeski; powiat grudziądzki; DONE
powiat golubsko-dobrzyński - powiat toruński; powiat wąbrzeski; powiat rypiński; powiat brodnicki; powiat lipnowski; DONE
powiat grudziądzki - Grudziądz; powiat świecki; powiat chełmiński; powiat wąbrzeski; powiat brodnicki; powiat kwidzyński; powiat nowomiejski; powiat iławski; DONE
powiat inowrocławski - powiat bydgoski; powiat toruński; powiat aleksandrowski; powiat mogileński; powiat radziejowski; powiat żniński; powiat koniński; DONE 
powiat lipnowski - powiat wrocławski; powiat aleksandrowski; powiat toruński; powiat golubsko-dobrzyński; powiat rypiński; powiat sierpecki; powiat płocki; DONE 
powiat mogileński - powiat żniński; powiat inowrocławski; powiat koniński; powiat słupecki; powiat gnieźnieński; DONE
powiat nakielski - powiat sępoleński; powiat bydgoski; powiat żniński; powiat wągrowiecki; powiat chodzieski; powiat pilski; DONE
powiat radziejowski - powiat inowrocławski; powiat aleksandrowski; powiat wrocławski; powiat kolski; powiat koniński; DONE
powiat rypiński - powiat lipnowski; powiat golubsko-dobrzyński; powiat brodnicki; powiat żuromiński; powiat sierpecki; DONE
powiat sępoleński - powiat bydgoski; powiat nakielski; powiat tucholski; powiat chojnicki; powiat człuchowski; powiat pilski; powiat złotowski; DONE
powiat świecki - Grudziądz; powiat grudziądzki; powiat chełmiński; powiat bydgoski; powiat tucholski; powiat kwidzyński; powiat tczewski; powiat starogardzki; DONE
powiat toruński - Toruń; Bydgoszcz; powiat bydgoski; powiat aleksandrowski; powiat inowrocławski; powiat lipnowski; powiat chełmiński; powiat golubsko-dobrzyński; powiat wąbrzeski; DONE
powiat tucholski - powiat świecki; powiat bydgoski; powiat sępoleński; powiat chojnicki; powiat starogardzki; DONE
powiat wąbrzeski - powiat grudziądzki; powiat chełmiński; powiat toruński; powiat golubsko-dobrzyński; powiat brodnicki; DONE
powiat włocławski - Włocławek; powiat radziejowski; powiat aleksandrowski; powiat lipnowski; powiat płocki; powiat gostyniński; powiat kutnowski; powiat kolski; DONE
powiat żniński - powiat nakielski; powiat bydgoski; powiat inowrocławski; powiat mogileński; powiat gnieźnieński; powiat wągrowiecki; DONE 
Bydgoszcz - powiat bydgoski; DONE 
Grudziądz - powiat świecki; powiat grudziądzki; DONE 
Toruń - powiat toruński; DONE
Włocławek - powiat włocławski; powiat aleksandrowski; powiat lipnowski; DONE
powiat bialski - powiat siemiatycki; Biała Podlaska; powiat łukowski; powiat radzyński; powiat parczewski; powiat włodawski; powiat łosicki; powiat siedlecki; DONE
powiat biłgorajski - powiat janowski; powiat lubelski; powiat krasnostawski; powiat zamojski; powiat tomaszowski; powiat niżański; powiat leżajski; powiat przeworski; powiat lubaczowski; DONE
powiat chełmski - powiat włodawski; powiat łęczyński; powiat świdnicki; powiat krasnostawski; powiat zamojski; powiat hrubieszowski; DONE
powiat hrubieszowski - powiat chełmski; powiat zamojski; powiat tomaszowski; DONE
powiat janowski - powiat kraśnicki; powiat lubelski; powiat biłgorajski; powiat stalowowolski; powiat niżański; DONE
powiat krasnostawski - powiat chełmski; powiat świdnicki; powiat lubelski; powiat biłgorajski; powiat zamojski; DONE
powiat kraśnicki - powiat opolski; powiat lubelski; powiat janowski; powiat opatowski; powiat sandomierski; powiat stalowowolski; DONE
powiat lubartowski - powiat parczewski; powiat radzyński; powiat rycki; powiat puławski; powiat lubelski; powiat łęczyński; DONE
powiat lubelski - powiat lubartowski; powiat puławski; powiat opolski; powiat kraśnicki; powiat janowski; powiat biłgorajski; powiat krasnostawski; powiat świdnicki; powiat łęczyński; DONE
powiat łęczyński - powiat lubartowski; powiat parczewski; powiat włodawski; powiat chełmski; powiat świdnicki; powiat lubelski; DONE
powiat łukowski - powiat bialski; powiat radzyński; powiat lubartowski; powiat rycki; powiat siedlecki; powiat garwoliński; DONE
powiat opolski - powiat opolski; powiat lubelski; powiat kraśnicki; powiat zwoleński; powiat lipski; powiat opatowski; DONE
powiat parczewski - powiat radzyński; powiat lubartowski; powiat bialski; powiat włodawski; powiat łęczyński; DONE
powiat puławski - powiat rycki; powiat lubartowski; powiat lubelski; powiat opolski; powiat kozienicki; powiat zwoleński; DONE
powiat radzyński - powiat łukowski; powiat lubartowski; powiat parczewski; powiat bialski; DONE
powiat rycki - powiat łukowski; powiat lubartowski; powiat puławski; powiat kozienicki; powiat garwoliński; DONE
powiat świdnicki - powiat lubelski; powiat łęczyński; powiat chełmski; powiat krasnostawski; Lublin; DONE
powiat tomaszowski - powiat hrubieszowski; powiat zamojski; powiat biłgorajski; powiat lubaczowski; DONE
powiat włodawski - powiat bialski; powiat parczewski; powiat łęczyński; powiat chełmski; DONE
powiat zamojski - powiat hrubieszowski; powiat chełmski; powiat krasnostawski; powiat biłgorajski; powiat tomaszowski; DONE
Biała Podlaska - powiat bialski; DONE
Chełm - powiat chełmski; DONE
Lublin - powiat lubelski; DONE 
Zamość - powiat zamojski; DONE
powiat gorzowski - Gorzów Wielkopolski; powiat strzelecko-drezdenecki; powiat międzyrzecki; powiat sulęciński; powiat słubicki; powiat myśliborski; DONE
powiat krośnieński - powiat słubicki; powiat sulęciński; powiat świebodziński; powiat zielonogórsko; powiat żarski; DONE
powiat międzyrzecki - powiat gorzowski; powiat świebodziński; powiat sulęciński; powiat strzelecko-drezdenecki; powiat międzychodzki; powiat nowotomyski; DONE
powiat nowosolski - powiat żagański; powiat zielonogórski; powiat Zielona Góra; powiat wschowski; powiat wolsztyński; powiat głogowski; DONE
powiat słubicki - powiat gorzowski; powiat sulęciński; powiat krośnieński; DONE 
powiat strzelecko-drezdenecki - powiat międzyrzecki; powiat gorzowski; powiat myśliborski; powiat choszczeński; powiat wałecki; powiat czarnkowsko-trzcianecki; powiat międzychodzki; DONE
powiat sulęciński - powiat gorzowski; powiat międzyrzecki; powiat świebodziński; powiat krośnieński; powiat słubicki; DONE
powiat świebodziński - powiat zielonogórski; powiat krośnieński; powiat sulęciński; powiat międzyrzecki; powiat nowotomyski; DONE
powiat zielonogórski - Zielona Góra; powiat nowosolski; powiat żagański; powiat żarski; powiat krośnieński; powiat świebodziński; powiat nowotomyski; powiat wolsztyński; DONE
powiat żagański - powiat żarski; powiat zielonogórski; powiat nowosolski; powiat polkowicki; powiat bolesławiecki; powiat zgorzelecki; DONE
powiat żarski - powiat krośnieński; powiat zielonogórski; powiat żagański; powiat zgorzelecki; DONE 
powiat wschowski - powiat nowosolski; powiat wolsztyński; powiat leszczyński; powiat górowski; powiat głogowski; DONE 
Gorzów Wielkopolski - powiat gorzowski; DONE
Zielona Góra - powiat zielonogórski; DONE
powiat bełchatowski - powiat pabianicki; powiat piotrkowski; powiat radomszczański; powiat pajęczański; powiat wieluński; powiat łaski; DONE 
powiat kutnowski - powiat gostyniński; powiat kolski; powiat łęczycki; powiat łowicki; powiat włocławski; DONE
powiat łaski - powiat zduńskowolski; powiat poddębicki; powiat pabianicki; powiat bełchatowski; powiat wieluński; powiat sieradzki; DONE
powiat łęczycki - powiat kutnowski; powiat łowicki; powiat zgierski; powiat poddębicki; powiat kolski; DONE
powiat łowicki - powiat skierniewicki; powiat brzeziński; powiat zgierski; powiat łęczycki; powiat kutnowski; powiat gostyniński; powiat sochaczewski; DONE 
powiat łódzki wschodni - powiat zgierski; powiat brzeziński; powiat tomaszowski; powiat piotrkowski; powiat pabianicki; DONE
powiat opoczyński - powiat konecki; powiat piotrkowski; powiat przysuski; powiat tomaszowski; DONE 
powiat pabianicki - powiat zgierski; powiat łódzki wschodni; powiat piotrkowski; powiat bełchatowski; powiat łaski; DONE 
powiat pajęczański - powiat wieluński; powiat bełchatowski; powiat radomszczański; powiat częstochowski; powiat kłobucki; DONE
powiat piotrkowski - powiat bełchatowski; powiat pabianicki; powiat łódzki wschodni; powiat tomaszowski; powiat opoczyński; powiat radomszczański; DONE
powiat poddębicki - powiat łęczycki; powiat zgierski; powiat pabianicki; powiat łaski; powiat zduńskowolski; powiat sieradzki; powiat turecki; powiat kolski; DONE
powiat radomszczański - powiat pajęczański; powiat bełchatowski; powiat piotrkowski; powiat konecki; powiat włoszczowski; powiat częstochowski; DONE
powiat rawski - powiat tomaszowski; powiat skierniewicki; powiat żyrardowski; powiat grójecki; DONE
powiat sieradzki - powiat poddębicki; powiat zduńskowolski; powiat łaski; powiat wieluński; powiat wieruszowski; powiat ostrzeszowski; powiat kaliski; powiat turecki; DONE
powiat skierniewicki - powiat rawski; powiat tomaszowski; powiat brzeziński; powiat łowicki; powiat sochaczewski; powiat żyrardowski; DONE
powiat tomaszowski - powiat opoczyński; powiat piotrkowski; powiat łódzki wschodni; powiat brzeziński; powiat skierniewicki; powiat rawski; powiat grójecki; powiat przysuski; DONE
powiat wieluński - powiat wieruszowski; powiat sieradzki; powiat łaski; powiat bełchatowski; powiat pajęczański; powiat kłobucki; powiat oleski; DONE
powiat wieruszowski - powiat ostrzeszowski; powiat kluczborski; powiat oleski; powiat wieluński; powiat sieradzki; powiat kępiński; DONE
powiat zduńskowolski - powiat łaski; powiat sieradzki; powiat poddębicki; DONE
powiat zgierski - powiat brzeski; łęczycki; powiat łowicki; powiat łódzki wschodni; Łódź; powiat pabianicki; powiat poddębicki; DONE
powiat brzeziński - powiat łowicki; powiat łódzki wschodni; powiat tomaszowski; powiat skierniewicki; powiat zgierski; DONE
Łódź - powiat łódzki wschodni; powiat zgierski; powiat pabianicki; DONE
Piotrków Trybunalski - powiat piotrkowski; DONE 
Skierniewice - powiat skierniewicki; DONE
powiat bocheński - powiat proszowicki; powiat krakowski; powiat wielicki; powiat limanowski; powiat nowosądecki; powiat brzeski; DONE
powiat brzeski - powiat bocheński; powiat limanowski; powiat nowosądecki; powiat tarnowski; powiat proszowicki; DONE
powiat chrzanowski - powiat krakowski; powiat oświęcimski; powiat wadowicki; powiat olkuski; powiat zawierciański; Jaworzno; DONE
powiat dąbrowski - powiat tarnowski; powiat dębicki; powiat mielecki; powiat staszowski; powiat buski; powiat kazimierski; DONE
powiat gorlicki - powiat tarnowski; powiat nowosądecki; powiat jasielski; DONE
powiat krakowski - Kraków; powiat wielicki; powiat olkuski; powiat miechowski; powiat proszowicki; powiat bocheński; powiat myślenicki; powiat wadowicki; powiat oświęcimski; powiat chrzanowski; DONE
powiat limanowski - powiat myślenicki; powiat nowotarski; powiat nowosądecki; powiat brzeski; powiat bocheński; DONE
powiat miechowski - powiat proszowicki; powiat krakowski; powiat olkuski; powiat zawierciański; powiat jędrzejowski; powiat pińczowski; powiat kazimierski; DONE
powiat myślenicki - powiat suski; powiat wadowicki; powiat krakowski; powiat wielicki; powiat bocheński; powiat limanowski; powiat nowotarski; DONE
powiat nowosądecki - powiat gorlicki; Nowy Sącz; powiat tarnowski; powiat brzeski; powiat limanowski; powiat nowotarski; DONE
powiat nowotarski - powiat nowosądecki; powiat limanowski; powiat myślenicki; powiat suski; powiat tatrzański; DONE 
powiat olkuski - powiat miechowski; powiat krakowski; powiat chrzanowski; powiat zawierciański; powiat będziński; Dąbrowa Górnicza; Jaworzno; DONE
powiat oświęcimski - powiat chrzanowski; powiat krakowski; powiat wadowicki; powiat bielski; powiat pszczyński; powiat bieruńsko-lędziński; DONE
powiat proszowicki - powiat krakowski; Kraków; powiat miechowski; powiat bocheński; powiat brzeski; powiat tarnowski; powiat buski; DONE
powiat suski - powiat nowotarski; powiat myślenicki; powiat wadowicki; powiat żywiecki; DONE
powiat tarnowski - Tarnów; powiat dąbrowski; powiat brzeski; powiat nowosądecki; powiat gorlicki; powiat dębicki; powiat jasielski; DONE
powiat tatrzański - powiat nowotarski; DONE 
powiat wadowicki - powiat suski; powiat myślenicki; powiat krakowski; powiat chrzanowski; powiat oświęcimski; powiat żywiecki; powiat bielski; DONE 
powiat wielicki - powiat krakowski; Kraków; powiat myślenicki; powiat bocheński; DONE
Kraków - powiat krakowski; powiat proszowicki; powiat wielicki; DONE
Nowy Sącz - powiat nowosądecki; DONE
Tarnów - powiat tarnowski; DONE
powiat białobrzeski - powiat grójecki; powiat kozienicki; powiat przysuski; powiat radomski; DONE
powiat ciechanowski - powiat makowski; powiat mławski; powiat płoński; powiat przasnyski; powiat pułtuski; DONE
powiat garwoliński - powiat grójecki; powiat kozienicki; powiat łukowski; powiat miński; powiat otwocki; powiat rycki; DONE 
powiat gostyniński - powiat kutnowski; powiat łowicki; powiat płocki; powiat sochaczewski; powiat włocławski; DONE
powiat grodziski - powiat pruszkowski; powiat piaseczyński; powiat grójecki; powiat żyrardowski; DONE
powiat grójecki - powiat białobrzeski; powiat garwoliński; powiat grodziski; powiat kozienicki; powiat otwocki; powiat piaseczyński; powiat przysuski; powiat rawski; powiat tomaszowski; powiat żyrardowski; DONE
powiat kozienicki - powiat zwoleński; powiat radomski; powiat białobrzeski; powiat grójecki; powiat garwoliński; powiat rycki; powiat puławski; DONE
powiat legionowski - Warszawa; powiat warszawski zachodni; powiat nowodworski; powiat pułtuski; powiat wyszkowski; powiat wołomiński; DONE 
powiat lipski - powiat radomski; powiat zwoleński; powiat opolski; powiat opatowski; powiat ostrowiecki; powiat starachowicki; DONE
powiat łosicki - powiat siedlecki; powiat siemiatycki; powiat bialski; DONE
powiat makowski - powiat wyszkowski; powiat pułtuski; powiat ciechanowski; powiat przasnyski; powiat ostrołęcki; DONE
powiat miński - powiat garwoliński; powiat otwocki; powiat wołomiński; powiat siedlecki; powiat węgrowski; Warszawa; DONE
powiat mławski - powiat przasnyski; powiat ciechanowski; powiat płoński; powiat żuromiński; powiat działdowski; powiat nidzicki; DONE
powiat nowodworski - powiat płoński; powiat pułtuski; powiat legionowski; powiat warszawski zachodni; powiat sochaczewski; DONE
powiat ostrołęcki - Ostrołęka; powiat ostrowski; powiat wyszkowski; powiat makowski; powiat przasnyski; powiat szczycieński; powiat piski; powiat kolneński; powiat łomżyński; DONE
powiat ostrowski - powiat sokołowski; powiat węgrowski; powiat wyszkowski; powiat ostrołęcki; powiat łomżyński; powiat zambrowski; powiat wysokomazowiecki; DONE
powiat otwocki - Warszawa; powiat piaseczyński; powiat miński; powiat garwoliński; powiat grójecki; DONE
powiat piaseczyński - Warszawa; powiat otwocki; powiat grójecki; powiat pruszkowski; powiat grodzki; DONE
powiat płocki - Płock; powiat sierpecki; powiat płoński; powiat sochaczewski; powiat gostyniński; powiat włocławski; powiat lipnowski; DONE
powiat płoński - powiat ciechanowski; powiat pułtuski; powiat nowodworski; powiat sochaczewski; powiat płocki; powiat sierpecki; powiat żuromiński; powiat mławski; DONE
powiat pruszkowski - Warszawa; powiat warszawski zachodni; powiat piaseczyński; powiat grodziski; DONE
powiat przasnyski - powiat ostrołęcki; powiat makowski; powiat ciechanowski; powiat mławski; powiat szczycieński; powiat nidzicki; DONE
powiat przysuski - powiat grójecki; powiat białobrzeski; powiat radomski; powiat szydłowiecki; powiat opoczyński; powiat tomaszowski; powiat konecki; DONE
powiat pułtuski - powiat makowski; powiat wyszkowski; powiat legionowski; powiat nowodworski; powiat płoński; powiat ciechanowski; DONE
powiat radomski - powiat szydłowiecki; powiat przysuski; powiat białobrzeski; powiat kozienicki; powiat zwoleński; powiat lipski; powiat starachowicki; Radom; DONE
powiat siedlecki - Siedlce; powiat łosicki; powiat garwoliński; powiat miński; powiat węgrowski; powiat sokołowski; powiat siemiatycki; powiat łukowski; powiat bialski; DONE
powiat sierpecki - powiat żuromiński; powiat płoński; powiat płocki; powiat lipnowski; powiat rypiński; DONE
powiat sochaczewski - powiat gostyniński; powiat płocki; powiat płoński; powiat nowodworski; powiat warszawski zachodni; powiat grodziski; powiat żyrardowski; powiat skierniewicki; DONE
powiat sokołowski - powiat siedlecki; powiat węgrowski; powiat ostrowski; powiat wysokomazowiecki; powiat siemiatycki; DONE
powiat szydłowiecki - powiat przysuski; powiat radomski; powiat starachowicki; powiat konecki; powiat skarżyski; DONE
powiat warszawski zachodni - Warszawa; powiat nowodworski; powiat legionowski; powiat pruszkowski; powiat grodzisko; powiat sochaczewski; DONE
powiat węgrowski - powiat wołomiński; powiat wyszkowski; powiat ostrowski; powiat sokołowski; powiat siedlecki; powiat miński; DONE
powiat wołomiński - Warszawa; powiat legionowski; powiat wyszkowski; powiat węgrowski; powiat miński; DONE
powiat wyszkowski - powiat węgrowski; powiat wołomiński; powiat legionowski; powiat pułtuski; powiat makowski; powiat ostrołęcki; powiat ostrowski; DONE
powiat zwoleński - powiat lipski; powiat radomski; powiat kozienicki; powiat puławski; powiat opolski; DONE
powiat żuromiński - powiat mławski; powiat płoński; powiat sierpecki; powiat brodnicki; powiat rypiński; powiat działdowski; DONE
powiat żyrardowski - powiat sochaczewski- powiat grodziski; powiat grójecki; powiat rawski; powiat skierniewicki; DONE 
Ostrołęka - powiat ostrołęcki; DONE
Płock - powiat płocki; DONE
Radom - powiat radomski; DONE
Siedlce - powiat siedlecki; DONE
Warszawa - powiat wołomiński; powiat warszawski zachodni; powiat legionowski; powiat piaseczyński; powiat pruszkowski; powiat otwocki; powiat miński; DONE
powiat brzeski - powiat nyski; powiat opolski; powiat namysłowski; powiat oławski; powiat strzeliński; DONE
powiat głubczycki - powiat prudnicki; powiat kędzierzyńsko-kozielski; powiat raciborski; DONE
powiat kędzierzyńsko-kozielski - powiat głubczycki; powiat prudnicki; powiat krapkowicki; powiat strzelecki; powiat gliwicki; powiat raciborski; DONE
powiat kluczborski - powiat oleski; powiat opolski; powiat namysłowski; powiat kępiński; powiat wieruszowski; DONE
powiat krapkowicki - powiat opolski; powiat strzelecki; powiat kędzierzyńsko-kozielski; powiat prudnicki; DONE
powiat namysłowski - powiat kluczborski; powiat opolski; powiat brzeski; powiat oławski; powiat oleśnicki; powiat kępiński; DONE
powiat nyski - powiat brzeski; powiat opolski; powiat prudnicki; powiat ząbkowicki; powiat strzeliński; DONE
powiat oleski - powiat strzelecki; powiat opolski; powiat kluczborski; powiat wieruszowski; powiat wieluński; powiat kłobucki; powiat lubliniecki; DONE
powiat opolski - Opole; powiat krapkowicki; powiat prudnicki; powiat nyski; powiat brzeski; powiat namysłowski; powiat kluczborski; powiat oleski; powiat strzelecki; DONE
powiat prudnicki - powiat nyski; powiat opolski; powiat krapkowicki; powiat kędzierzyńsko-kozielski; powiat głubczycki; DONE
powiat strzelecki - powiat kędzierzyńsko-kozielski; powiat krapkowicki; powiat opolski; powiat oleski; powiat lubliniecki; powiat tarnogórski; powiat gliwicki; DONE
Opole - powiat opolski; DONE
powiat bieszczadzki - powiat przemyski; powiat sanocki; powiat leski; 
powiat brzozowski - powiat przemyski; powiat rzeszowski; powiat strzyżowski; powiat krośnieński; powiat sanocki; DONE
powiat dębicki - powiat mielecki; powiat ropczycko-sędziszowski; powiat strzyżowski; powiat jasielski; powiat tarnowski; powiat dąbrowski; DONE
powiat jarosławski - powiat lubaczowski; powiat przeworski; powiat przemyski; DONE
powiat jasielski - powiat dębicki; powiat strzyżowski; powiat krośnieński; powiat gorlicki; powiat tarnowski; DONE
powiat kolbuszowski - powiat stalowowolski; powiat tarnobrzeski; powiat mielecki; powiat niżański; powiat rzeszowski; powiat ropczycko-sędziszowski; DONE 
powiat krośnieński - powiat jasielski; powiat strzyżowski; powiat brzozowski; powiat sanocki; Krosno; DONE
powiat leżajski - powiat niżański; powiat rzeszowski; powiat łańcucki; powiat przeworski; powiat biłgorajski; DONE
powiat lubaczowski - powiat tomaszowski; powiat biłgorajski; powiat przeworski; powiat jarosławski; DONE
powiat łańcucki - powiat leżajski; powiat przeworski; powiat rzeszowski; DONE 
powiat mielecki - powiat tarnobrzeski; powiat kolbuszowski; powiat ropczycko-sędziszowski; powiat dębicki; powiat dąbrowski; powiat staszowski; DONE
powiat niżański - powiat leżajski; powiat stalowowolski; powiat kolbuszowski; powiat rzeszowski; powiat biłgorajski; powiat janowski; DONE
powiat przemyski - Przemyśl; powiat jarosławski; powiat przeworski; powiat rzeszowski; powiat brzozowski; powiat sanocki; powiat bieszczadzki; DONE
powiat przeworski - powiat lubaczowski; powiat jarosławski; powiat przemyski; powiat rzeszowski; powiat łańcucki; powiat leżajski; powiat biłgorajski; DONE
powiat ropczycko-sędziszowski - powiat kolbuszowski; powiat mielecki; powiat dębicki; powiat strzyżowski; powiat rzeszowski; DONE 
powiat rzeszowski - powiat łańcucki; powiat leżajski; powiat niżański; powiat kolbuszowski; powiat ropczycko-sędziszowski; powiat strzyżowski; powiat brzozowski; powiat przemyski; DONE
powiat sanocki - powiat bieszczadzki; powiat leski; powiat przemyski; powiat brzozowski; powiat krośnieński; DONE
powiat stalowowolski - powiat tarnobrzeski; powiat kolbuszowski; powiat niżański; powiat sandomierski; powiat janowski; powiat kraśnicki; DONE
powiat strzyżowski - powiat ropczycko-sędziszowski; powiat dębicki; powiat rzeszowski; powiat brzozowski; powiat krośnieński; powiat jasielski;DONE
powiat tarnobrzeski - Tarnobrzeg; powiat stalowowolski; powiat kolbuszowski; powiat mielecki; powiat sandomierski; powiat staszowski; DONE
powiat leski - powiat bieszczadzki; powiat sanocki; DONE
Krosno - powiat krośnieński; DONE
Przemyśl - powiat przemyski; DONE
Rzeszów - powiat rzeszowski; DONE
Tarnobrzeg - powiat Tarnobrzeski; powiat sandomierski; DONE 
powiat augustowski - powiat suwalski; powiat sejneński; powiat sokólski; powiat moniecki; powiat grajewski; powiat ełcki; DONE
powiat białostocki - powiat sokólski; powiat moniecki; powiat łomżyński; powiat zambrowski; powiat wysokomazowiecki; powiat bielski; powiat hajnowski; DONE
powiat bielski - powiat białostocki; powiat wysokomazowiecki; powiat siemiatycki; powiat hajnowski; DONE
powiat grajewski - powiat augustowski; powiat moniecki; powiat kolneński; powiat łomżyński; powiat ełcki; DONE
powiat hajnowski - powiat bielski; powiat białostocki; powiat siemiatycki; DONE 
powiat kolneński - powiat grajewski; powiat łomżyński; powiat piski; powiat ostrołęcki; DONE
powiat łomżyński - powiat kolneński; powiat grajewski; powiat moniecki; powiat białostocki; powiat zambrowski; powiat ostrołęcki; powiat ostrowski; DONE
powiat moniecki - powiat augustowski; powiat sokólski; powiat grajewski; powiat łomżyński; powiat białostocki; DONE
powiat sejneński - powiat suwalski; powiat augustowski; DONE 
powiat siemiatycki - powiat wysokomazowiecki; powiat bielski; powiat hajnowski; powiat sokołowski; powiat siedlecki; powiat łosicki; powiat bialski; DONE
powiat sokólski - powiat augustowski; powiat moniecki; powiat białostocki; DONE
powiat suwalski - Suwałki; powiat gołdapski; powiat ełcki; powiat olecki; powiat sejneński; powiat augustowski; DONE
powiat wysokomazowiecki - powiat zambrowski; powiat białostocki; powiat bielski; powiat siemiatycki; powiat ostrowski; powiat sokołowski; DONE
powiat zambrowski - powiat łomżyński; powiat białostocki; powiat wysokomazowiecki; powiat ostrowski; DONE
Białystok - powiat białostocki; DONE
Łomża - powiat łomżyński; DONE
Suwałki - powiat suwalski; DONE
powiat bytowski - powiat słupski; powiat lęborski; powiat kartuski; powiat kościerski; powiat chojnicki; powiat człuchowski; powiat koszaliński; powiat szczecinecki; DONE
powiat chojnicki - powiat człuchowski; powiat bytowski; powiat kościerski; powiat starogardzki; powiat sępoleński; powiat tucholski; DONE 
powiat człuchowski - powiat bytowski; powiat chojnicki; powiat szczecinecki; powiat złotowski; powiat sępoleński; DONE
powiat gdański - Gdańsk; powiat kartuski; powiat kościerski; powiat starogardzki; powiat tczewski; powiat malborski; powiat nowodworski; DONE
powiat kartuski - powiat wejherowski; powiat lęborski; powiat bytowski; powiat kościerski; powiat gdański; Gdańsk; Gdynia; DONE
powiat kościerski - powiat kartuski; powiat bytowski; powiat chojnicki; powiat starogardzki; DONE 
powiat kwidzyński - powiat sztumski; powiat tczewski; powiat świecki; powiat grudziądzki; powiat iławski; DONE
powiat lęborski - powiat słupski; powiat bytowski; powiat kartuski; powiat wejherowski; DONE
powiat malborski - powiat nowodworski; powiat gdański; powiat tczewski; powiat sztumski; powiat elbląski; DONE
powiat nowodworski - powiat malborski; powiat gdański; Gdańsk; powiat elbląski; DONE
powiat pucki - powiat wejherowski; Gdynia; DONE
powiat słupski - powiat sławieński; powiat koszaliński; Słupsk; powiat bytowski; powiat lęborski; DONE
powiat starogardzki - powiat tczewski; powiat gdański; powiat kościerski; powiat chojnicki; powiat tucholski; powiat świecki; DONE 
powiat tczewski - powiat starogardzki; powiat gdański; powiat malborski; powiat sztumski; powiat kwidzyński; powiat świecki; DONE
powiat wejherowski - powiat lęborski; powiat kartuski; Gdynia; powiat pucki; DONE
powiat sztumski - powiat malborski; powiat tczewski; powiat kwidzyński; powiat elbląski; powiat ostródzki; powiat iławski; DONE
Gdańsk - Sopot; Gdynia; powiat kartuski; powiat gdański; powiat nowodworski; DONE
Gdynia - powiat pucki; powiat wejherowski; powiat kartuski; Sopot; Gdańsk; DONE
Słupsk - powiat słupski; DONE
Sopot - Gdynia; Gdańsk; DONE
powiat będziński - Dąbrowa Górnicza; Sosnowiec; Jaworzno; powiat olkuski;  powiat zawierciański; powiat myszkowski; powiat tarnogórski; Piekary Śląskie; Siemianowice Śląskie; Katowice; DONE
powiat bielski - powiat pszczyński; powiat cieszyński; powiat żywiecki; Bielsko-Biała; powiat oświęcimski; powiat wadowicki; DONE
powiat cieszyński - powiat bielski; Bielsko-Biała; powiat żywiecki; powiat pszczyński; Jastrzębie-Zdrój; DONE
powiat częstochowski -  powiat kłobucki; Częstochowa; powiat lubliniecki; powiat myszkowski; powiat zawierciański; powiat lubliniecki; powiat pajęczański; powiat radomszczański; powiat włoszczowski; DONE  
powiat gliwicki - Gliwice; Zabrze; Rybnik; Ruda Śląska; powiat mikołowski; powiat raciborski; powiat rybnicki; powiat tarnogórski; powiat kędzierzyńsko-kozielski; powiat strzelecki; DONE
powiat kłobucki - Częstochowa; powiat częstochowski; powiat lubliniecki; powiat oleski; powiat wieluński; powiat pajęczański; DONE 
powiat lubliniecki - powiat kłobucki; powiat częstochowski; powiat myszkowski; powiat tarnogórski; powiat strzelecki; powiat oleski; DONE
powiat mikołowski - Katowice; Tychy; Ruda Śląska; Zabrze; powiat gliwicki; powiat rybnicki; Żory; powiat pszczyński; DONE
powiat myszkowski - powiat zawierciański; powiat będziński; powiat tarnogórski; powiat lubliniecki; powiat częstochowski; 
powiat pszczyński - powiat bieruńsko-lędziński; Tychy; powiat mikołowski; Żory; Jastrzębie-Zdrój; powiat cieszyński; powiat bielski; powiat oświęcimski; DONE
powiat raciborski - powiat głubczycki; powiat kędzierzyńsko-kozielski; powiat gliwicki; powiat rybnicki; powiat wodzisławski; Rybnik; DONE
powiat rybnicki - Rybnik; Żory; powiat raciborski; powiat wodzisławski; powiat gliwicki; powiat mikołowski; Jastrzębie-Zdrój; DONE
powiat tarnogórski - Bytom; Gliwice; Piekary Śląskie; Zabrze; powiat będziński; powiat gliwicki; powiat lubliniecki; powiat myszkowski; powiat strzelecki; DONE
powiat bieruńsko-lędziński - Tychy; powiat pszczyński; Katowice; Mysłowice; Jaworzno; powiat oświęcimski; DONE
powiat wodzisławski - Jastrzębie-Zdrój; powiat rybnicki; Rybnik; powiat raciborski; DONE
powiat zawierciański - zawierciański myszkowski; zawierciański będziński; zawierciański częstochowski; Dąbrowa Górnicza; powiat włoszczowski; powiat jędrzejowski; powiat olkuski; powiat miechowski; DONE 
powiat żywiecki - powiat cieszyński; powiat bielski; Bielsko-Biała; powiat suski; powiat wadowicki; DONE
Bielsko-Biała - powiat żywiecki; powiat bielski; powiat cieszyński; DONE
Bytom - Chorzów; Piekary Śląskie; powiat tarnogórski; Zabrze; Ruda Śląska; DONE
Chorzów - Katowice; Siemianowice Śląskie; Piekary Śląskie; Bytom; Świętochłowice; Ruda Śląska; DONE
Częstochowa - powiat częstochowski; powiat kłobucki; DONE
Dąbrowa Górnicza - Sosnowiec; powiat będziński; powiat zawierciański; DONE
Gliwice - powiat tarnogórski; powiat gliwicki; Zabrze; DONE 
Jastrzębie-Zdrój - powiat cieszyński; powiat pszczyński; Żory; powiat rybnicki; powiat wodzisławski; DONE
Jaworzno - Sosnowiec; Mysłowice; powiat będziński; powiat bieruńsko-lędziński; powiat olkuski; powiat chrzanowski; DONE
Katowice - Sosnowiec; Mysłowice; Tychy; powiat mikołowski; Ruda Śląska; Chorzów; Siemianowice Śląskie; powiat będziński; DONE
Mysłowice - Katowice; powiat bieruńsko-lędziński; Jaworzno; Sosnowiec; DONE
Piekary Śląskie - Siemianowice Śląskie; Bytom; powiat będziński; powiat tarnogórski; DONE
Ruda Śląska - Zabrze; Bytom; Chorzów; Katowice; powiat mikołowski; Świętochłowice; DONE
Rybnik - powiat rybnicki; Żory; powiat wodzisławski; powiat gliwicki; powiat raciborski; DONE
Siemianowice Śląskie - Piekary Śląskie; Katowice; Chorzów; powiat będziński; DONE
Sosnowiec - Dąbrowa Górnicza; Katowice; Jaworzno; Mysłowice; powiat będziński; DONE
Świętochłowice - Chorzów; Bytom; Ruda Śląska; DONE
Tychy - powiat bieruńsko-lędziński; powiat pszczyński; powiat mikołowski; Katowice; DONE
Zabrze - Bytom; Gliwice; Ruda Śląska; powiat gliwicki; powiat mikołowski; powiat tarnogórski; DONE 
Żory - powiat pszczyński; Jastrzębie-Zdrój; powiat rybnicki; Rybnik; powiat mikołowski; DONE
powiat buski - powiat kazimierski; powiat pińczowski; powiat kielecki; powiat staszowski; powiat dąbrowski; DONE  
powiat jędrzejowski - powiat włoszczowski; powiat kielecki; powiat pińczowski; powiat miechowski; powiat zawierciański; DONE
powiat kazimierski - powiat pińczowski; powiat buski; powiat dąbrowski; powiat tarnowski; powiat proszowicki; powiat miechowski; DONE
powiat kielecki- Kielce; powiat konecki; powiat skarżyski; powiat starachowicki; powiat ostrowiecki; powiat opatowski; powiat staszowski; powiat buski; powiat pińczowski; powiat jędrzejowski; powiat włoszczowski; DONE 
powiat konecki - powiat skarżyski; powiat kielecki; powiat włoszczowski; powiat radomszczański; powiat opoczyński; powiat przysuski; powiat szydłowiecki; DONE
powiat opatowski - powiat sandomierski; powiat staszowski; powiat kielecki; powiat ostrowiecki; powiat lipski; powiat opolski; powiat kraśnicki; DONE
powiat ostrowiecki - powiat opatowski; powiat kielecki; powiat starachowicki; powiat lipski; DONE
powiat pińczowski - powiat kielecki; powiat buski; powiat kazimierski; powiat miechowski; powiat jędrzejowski; DONE
powiat sandomierski - powiat staszowski; powiat opatowski; powiat kraśnicki; powiat stalowowolski; powiat tarnobrzeski; Tarnobrzeg; DONE
powiat skarżyski - powiat kielecki; powiat konecki; powiat starachowicki; powiat szydłowiecki; DONE
powiat starachowicki - powiat ostrowiecki; powiat kielecki; powiat skarżyski; powiat szydłowiecki; powiat radomski; powiat lipski; DONE
powiat staszowski - powiat buski; powiat kielecki; powiat opatowski; powiat sandomierski; powiat tarnobrzeski; powiat mielecki; powiat dąbrowski; DONE 
powiat włoszczowski - powiat konecki; powiat kielecki; powiat jędrzejowski; powiat zawierciański; powiat częstochowski; powiat radomszczański; DONE 
Kielce - powiat kielecki; DONE
powiat bartoszycki - powiat braniewski; powiat lidzbarski; powiat olsztyński; powiat kętrzyński; DONE
powiat braniewski - powiat elbląski; powiat lidzbarski; powiat bartoszycki; DONE
powiat działdowski - powiat nowomiejski; powiat iławski; powiat ostródzki; powiat nidzicki; powiat brodnicki; powiat żuromiński; DONE
powiat elbląski - Elbląg; powiat malborski; powiat nowodworski; powiat sztumski; powiat ostródzki; powiat lidzbarski; powiat braniewski; DONE
powiat ełcki - powiat olecki; powiat giżycki; powiat piski; powiat suwalski; powiat augustowski; powiat grajewski; DONE
powiat giżycki - powiat węgorzewski; powiat kętrzyński; powiat mrągowski; powiat piski; powiat ełcki; powiat olecki; powiat gołdapski; DONE
powiat iławski - powiat ostródzki; powiat nowomiejski; powiat działdowski; powiat sztumski; powiat kwidzyński; DONE
powiat kętrzyński - powiat bartoszycki; powiat olsztyński; powiat mrągowski; powiat giżycki; powiat węgorzewski; DONE
powiat lidzbarski - powiat bartoszycki; powiat braniewski; powiat elbląski; powiat ostródzki; powiat olsztyński; DONE 
powiat mrągowski - powiat kętrzyński; powiat olsztyński; powiat szczycieński; powiat piski; powiat giżycki; DONE
powiat nidzicki - powiat olsztyński; powiat ostródzki; powiat działdowski; powiat szczycieński; powiat mławski; powiat przasnyski; DONE
powiat nowomiejski - powiat iławski; powiat działdowski; powiat grudziądzki; powiat brodnicki; DONE
powiat olecki - powiat gołdapski; powiat giżycki; ełcki; powiat suwalski; DONE
powiat olsztyński - powiat mrągowski; powiat kętrzyński; powiat bartoszycki; powiat lidzbarski; powiat ostródzki; powiat nidzicki; powiat szczycieński; DONE
powiat ostródzki - powiat elbląski; powiat iławski; powiat lidzbarski; powiat olsztyński; powiat działdowski; powiat nidzicki; DONE
powiat piski - powiat szczycieński; powiat mrągowski; powiat giżycki; powiat ełcki; powiat ostrołęcki; powiat kolneński; DONE
powiat szczycieński - powiat piski; powiat mrągowski; powiat olsztyński; powiat nidzicki; powiat ostrołęcki; powiat przasnyski; DONE
powiat gołdapski - powiat węgorzewski; powiat giżycki; powiat olecki; powiat suwalski; DONE
powiat węgorzewski - powiat kętrzyński; powiat giżycki; powiat gołdapski; DONE
Elbląg - powiat elbląski; DONE
Olsztyn - powiat olsztyński; DONE
powiat chodzieski - powiat wągrowiecki; powiat obornicki; powiat czarnkowsko-trzcianecki; powiat pilski; DONE
powiat czarnkowsko-trzcianecki - powiat wałecki; powiat pilski; powiat chodzieski; powiat obornicki; powiat szamotulski; powiat międzychodzki; powiat strzelecko-drezdenecki; DONE
powiat gnieźnieński - powiat słupecki; powiat wrzesiński; powiat poznański; powiat wągrowiecki; powiat żniński; powiat mogileński; DONE
powiat gostyński - powiat kościański; powiat śremski; powiat jarociński; powiat krotoszyński; powiat rawicki; powiat leszczyński; DONE
powiat grodziski - powiat poznański; powiat kościański; powiat wolsztyński; powiat nowotomyski; DONE
powiat jarociński - powiat gostyński; powiat śremski; powiat średzki; powiat wrzesiński; powiat pleszewski; powiat krotoszyński; DONE
powiat kaliski - Kalisz; powiat ostrzeszowski; powiat ostrowski; powiat pleszewski; powiat koniński; powiat turecki; powiat sieradzki; DONE
powiat kępiński - powiat ostrzeszowski; powiat wieruszowski; powiat kluczborski; powiat namysłowski; powiat oleśnicki; DONE
powiat kolski - powiat koniński; powiat turecki; powiat kutnowski; powiat łęczycki; powiat poddębicki; powiat radziejowski; powiat włocławski; DONE
powiat koniński - Konin; powiat kolski; powiat turecki; powiat kaliski; powiat pleszewski; powiat słupecki; powiat mogileński; powiat radziejowski; powiat inowrocławski; DONE
powiat kościański - powiat grodzki; powiat poznański; powiat śremski; powiat gostyński; powiat leszczyński; powiat wolsztyński; DONE
powiat krotoszyński - powiat rawicki; powiat gostyński; powiat jarociński; powiat pleszewski; powiat ostrowski; powiat milicki; DONE
powiat leszczyński - Leszno; powiat wolsztyński; powiat kościański; powiat gostyński; powiat rawicki; powiat górowski; powiat wschowski; DONE 
powiat międzychodzki - powiat czarnkowsko-trzcianecki; powiat szamotulski; powiat nowotomyski; powiat międzyrzecki; powiat strzelecko-drezdenecki; DONE
powiat nowotomyski - powiat międzychodzki; powiat szamotulski; powiat poznański; powiat grodziski; powiat wolsztyński; powiat zielonogórski; powiat świebodziński; powiat międzyrzecki; DONE
powiat obornicki - powiat czarnkowsko-trzcianecki; powiat chodzieski; powiat wągrowiecki; powiat poznański; powiat szamotulski; DONE
powiat ostrowski - Kalisz; powiat kaliski; powiat krotoszyński; powiat milicki; powiat ostrzeszowski; powiat oleśnicki; powiat pleszewski; DONE
powiat ostrzeszowski - powiat kępiński; powiat ostrowski; powiat kaliski; powiat sieradzki; powiat wieruszowski; powiat oleśnicki; DONE
powiat pilski - powiat złotowski; powiat wągrowiecki; powiat chodzieski; powiat czarnkowsko-trzcianecki; powiat wałecki; powiat sępoleński; powiat nakielski; DONE
powiat pleszewski - powiat jarociński; powiat wrzesiński; powiat słupecki; powiat koniński; powiat kaliski; powiat ostrowski; powiat krotoszyński; DONE
powiat poznański - powiat gnieźnieński; powiat wrzesiński; powiat średzki; powiat śremski; powiat kościański; powiat obornicki; powiat grodziski; powiat szamotulski; powiat nowotomyski; powiat wągrowiecki; Poznań; DONE
powiat rawicki - powiat leszczyński; powiat gostyński; powiat krotoszyński; powiat milicki; powiat trzebnicki; powiat górowski; DONE
powiat słupecki - powiat gnieźnieński; powiat wrzesiński; powiat pleszewski; powiat koniński; powiat mogileński; DONE
powiat szamotulski - powiat czarnkowsko-trzcianecki; powiat nowotomyski; powiat międzychodzki; powiat obornicki; powiat poznański; DONE
powiat średzki - powiat wrzesiński; powiat jarociński; powiat śremski; powiat poznański; DONE
powiat śremski - powiat poznański; powiat średzki; powiat jarociński; powiat gostyniński; powiat kościański; DONE
powiat turecki - powiat kolski; powiat koniński; powiat kaliski; powiat poddębicki; powiat sieradzki; DONE
powiat wągrowiecki - powiat gnieźnieński; powiat poznański; powiat chodzieski; powiat nakielski; powiat żniński; powiat pilski; powiat obornicki; DONE
powiat wolsztyński - powiat nowotomyski; powiat grodziski; powiat kościański; powiat leszczyński; powiat wschowski; powiat nowosolski; powiat zielonogórski; DONE
powiat wrzesiński - powiat pleszewski; powiat jarociński; powiat średzki; powiat poznański; powiat gnieźnieński; powiat słupecki; DONE
powiat złotowski - powiat pilski; powiat wałecki; powiat drawski; powiat szczecinecki; powiat człuchowski; powiat sępoleński; DONE
Kalisz - powiat kaliski; powiat pleszewski; powiat ostrowski; DONE
Konin - powiat koniński; DONE
Leszno - powiat leszczyński; DONE
Poznań - powiat poznański; DONE
powiat białogardzki - powiat koszaliński; powiat koszaliński; powiat świdwiński; powiat szczecinecki; DONE
powiat choszczeński - powiat myśliborski; powiat stargardzki; powiat drawski; powiat wałecki; powiat strzelecko-drezdenecki; DONE
powiat drawski - powiat choszczeński; powiat wałecki; powiat szczecinecki; powiat świdwiński; powiat łobeski; powiat stargardzki; powiat złotowski; DONE
powiat goleniowski - powiat łobeski; powiat gryficki; powiat kamieński; Świnoujście; powiat policki; Szczecin; powiat stargardzki; DONE
powiat gryficki - powiat kamieński; powiat goleniowski; powiat łobeski; powiat kołobrzeski; DONE 
powiat gryfiński - powiat policki; Szczecin; powiat stargardzki; powiat pyrzycki; powiat myśliborski; DONE
powiat kamieński - Świnoujście; powiat goleniowski; powiat gryficki; DONE
powiat kołobrzeski - powiat gryficki; powiat łobeski; powiat świdwiński; powiat białogardzki; powiat koszaliński;DONE
powiat koszaliński - Koszalin, powiat kołobrzeski; powiat białogardzki; powiat szczecinecki; powiat sławieński; powiat słupski; powiat bytowski; DONE
powiat myśliborski - powiat pyrzycki; powiat gryfiński; powiat stargardzki; powiat choszczeński; powiat gorzowski; powiat strzelecko-drezdenecki; DONE
powiat policki - Świnoujście; powiat goleniowski; Szczecin; powiat gryfiński; DONE
powiat pyrzycki - powiat gryfiński; powiat myśliborski; powiat stargardzki; DONE
powiat sławieński - powiat koszaliński; powiat słupski; DONE
powiat stargardzki - Szczecin; powiat goleniowski; powiat łobeski; powiat drawski; powiat choszczeński; powiat myśliborski; powiat pyrzycki; powiat gryfiński; DONE
powiat szczecinecki - powiat koszaliński; powiat białogardzki; powiat świdwiński; powiat drawski; powiat bytowski; powiat człuchowski; powiat złotowski; DONE
powiat świdwiński - powiat białogardzki; powiat kołobrzeski; powiat łobeski; powiat drawski; powiat szczecinecki; DONE
powiat wałecki - powiat drawski; powiat choszczeński; powiat złotowski; powiat pilski; powiat czarnkowsko-trzcianecki; powiat strzelecko-drezdenecki; DONE
powiat łobeski - powiat świdwiński; powiat kołobrzeski; powiat gryficki; powiat goleniowski; powiat stargardzki; powiat drawski; DONE
Koszalin - powiat koszaliński; DONE 
Szczecin - powiat policki; powiat goleniowski; powiat stargardzki; powiat gryfiński; DONE
Świnoujście - powiat kamieński; powiat policki; powiat goleniowski; DONE
